aardig	nice / kind (about human)
alles	everything
begrijpen	to understand
beneden	down, downstairs
beschikbaar	available
bij	at, near
blijven	to stay / to remain
borrelen	to have a drink
de arm	the arm
de bes	the berry
de bloemkool	the cauliflower
de boerenkool	the kale
de gracht	the canal
de kast	the closet
de kool	the cabbage
de kruk	the stool
de neerslag	the precipitation
de plek	the place
de vertegenwoordiger	the representative
de woning	the living place (residence)
deze	this / these
die	that / those
door	through
dragen	to carry / to wear
eenvoudig	simple
enige	(my/the) only (+smth)
erg	very
het boek	the book
het gerecht	the dish
het grachtenpand	the canal house
het haar	the hair
het midden	the middle
het woonadres	the home address
hoog	high, tall
iets	something
laag	low
na	after
naar	to
niet	not
pas	just (a small time ago)
roken	to smoke
saai	boring
straks	later
te veel	too much
uw	your (formal)
vasthouden	to hold (in hand)
veel	many / much / a lot
vies	dirty, disgusting
