Ik spreek alleen in het Engels	Я говорю только по английски
alsjeblieft	пожалуйста
antwoorden	to answer / to reply
bedankt	спасибо
beginnen	to begin / to start
begrijpen	to understand
beter	better
blauw	blue
de echtgenoot	the husband 
de echtgenote	the wife
dik	big / fat
duur	expensive
en	and
gaan	to go
geven	to give
goed	good / right / correct
goedeavond	добрый вечер
goedemiddag	добрый день
goedemorgen	доброе утро
groot	large / big / tall / great / major
hallo	здравствуйте
helpen	to help
hoi	привет
horen	to hear
kennen	to know people
kijken naar	to watch
klein	small / little
komen	to come
kort	short
koud	cold
lang	long / tall
langzaam	slow
lezen	to read
makkelijk	easy
mijn naam is	меня зовут …
moeilijk	difficult / hard
nemen	to take
nieuw	new
of	or
rood	red
schrijven	to write
slapen	to sleep
slecht	bad / wrong / incorrect
slechtst	worst
snel	fast / quick
sorry	извините
tellen	to count
uitleggen	to explain
vinden	to find / to discover
vragen	to ask / to request
wachten	to wait
warm	warm
weggaan	to leave
weten	to know facts
wijn of water	wine or water
willen	to want
wit	white
zeggen	to say
zien	to see
zoeken	to look for / to search
zwart	black
