aannemen	to receive what offered, to accept
achtergelaten	abandoned
al	already, yet
alsof	as if
automatische	automatic
bang	afraid, scared
behoorlijk	proper, decent
bekend	well-known
bekijken	to look at
beloofd	promised
beroemde	famous
beroven	to rob
beschouwen	to regard
bezig	busy
bidden	to pray
bijna	almost
bijzonder	unusual, special
dapper	brave
de angst	the fear
de baas	the boss
de beer	the bear
de beloning	the reward
de bon	the receipt
de deal	the deal
de dobbelstenen	the dice
de eenhoorn	the unicorn
de haat	the hate
de handtekening	the signature
de heer	the lord
de held	the hero
de hoek	the angle, corner
de hoeveelheid	the quantity
de laarzen	the boots
de meneer	the sir
de misdaad	the crime
de oefening	the excercise
de ontspanning	the relaxation
de onzin	the nonsense
de regel	the rule
de reis	the trip
de schaamte	the shame
de staart	the tail
de steen	the stone
de vertaling	the translation
de zak	the bag
degenen	those
dezelfde	the same
eenvoudige	simple
eindelijk	finally
elk	each
enkele	few, some
gelukkig	happy (adj/adv)
geweldig	awesome
grappig	funny
het avontur	adventure
het bezoek	the visit
het ding	the thing
het einde	the end
het gat	the hole
het geluk	the happiness
het genot	the pleasure
het graf	the grave
het spul	the stuff
het volk	the people
jezelf	yourself
de kennis	knowledge
de kerk	church
knappe	handsome
lage	low (+ noun)
leuk	fun, nice
meestal	usually
mezelf	myself
nobele	noble
onsterfelijk	immortal
onszelf	ourselves
precies	precisely
riskeren	to risk
ruiken	to smell
Spaanse	Spanish
stalen	steel (adj)
verborgen	hidden
voorzichtig	careful
vorige	previous
werkelijk	actual, actually
zich	(it-him-her)self short
zichzelf	(it-him-her)self
zitten	to sit
zoveel	so much
